VVVVVVVVVVVVV
V   V   V   V
VVV V V V V V
V   V V   V V
V VVVVVVVVV V
V V     V   V
V V VVV V VVV
V V V V V   V
V V V V VVV V
V   V V     V
VVVVV VVVVV V
V           N
VVVVVVVVVVVVV
